111111111111111111111
1C000E001100011110001
11000P1100000V0000001
1000000C0000000C00C01
1100000000V000000C101
1111000C00000011C1101
10000000C000000000001
111111111111111111111