1111111111111
1P0000E001C01
11VC000000011
1111111111111