111111111111
1P000E001C01
11VC00000011
111111111111