111111111111111111111
1C000000E100011110001
11000P1100000V0000001
1000100C0000000C00C01
1100000000V000000C101
111000C000000011C1101
11000000CV00000000001
111111111111111111111