111111111111111111111111111111111111111111
1000C000C00000C000CCCCCC001000000000000001
100000001111000000C0000C001000000000000001
100011000000110000000000011000000000000001
1000011110000001111V11110000V0000000000001
11110000000000000000000000111111V011111111
1E00000V0CCC0000V00000000000000000000000P1
111111111111111111111111111111111111111111