111111111111111111111111111111111111111111
1E00011111110000000000CCC000000000V0000001
100000000000000000000000111110000000000001
11111111111111111111111111111111111111V0V1
100000000000000000000000000000000C00000001
1111111111111111V0V11111111111111111111111
10000000C0000000000000000000000000000000P1
111111111111111111111111111111111111111111