1111111111111111111111111111111111111111111111111111111111111111111111111111111111111
1000000CCCCCCC000000000000000000000000000CCC0000000000000000000000000000CCCCCCC000001
1000000CCCCCCC00000000000000000000000000C000C000000000000000000000000000CCCCCCC000001
1000000CCCCCCC00000000000000V00000000000CCCCC000000000000000000000000000CCCCCCC000001
1000000000V00000000V0000000000000000000CCCPCCC0000000000000V000000000000000V000000001
10000000V000011100000V0000000000000000CCCCCCCCC00000000000V0000000000111000000V000001
100000V000000111000000000000000000000CCCCCCCCCCC0000000000000000000001110000000000001
100000000000011100000000000000000000CCCCCCCCCCCCC000000000000000000001110000000000001
1000000000V00000000000000V000000000000000000000000000000000000000000000V0000000000001
100CCCCC00000000000V00000000000000000000000000000000000000V000000000000000000CCCCC001
10000C0000000000000V00000000000000000000000E00000000000000000000000V00000000000C00001
1111111111111111111111111111111111111111111111111111111111111111111111111111111111111